"filename", "language", "SCSS", "TypeScript", "CSS", "JavaScript", "HTML", "comment", "blank", "total"
"/media/roman/414054776F940E4C/Projects/PARAtask/paratime/src/app/app-routing.module.ts", "TypeScript", 0, 30, 0, 0, 0, 0, 4, 34
"/media/roman/414054776F940E4C/Projects/PARAtask/paratime/src/app/app.component.css", "CSS", 0, 0, 0, 0, 0, 0, 1, 1
"/media/roman/414054776F940E4C/Projects/PARAtask/paratime/src/app/app.component.html", "HTML", 0, 0, 0, 0, 1, 0, 0, 1
"/media/roman/414054776F940E4C/Projects/PARAtask/paratime/src/app/app.component.spec.ts", "TypeScript", 0, 31, 0, 0, 0, 0, 5, 36
"/media/roman/414054776F940E4C/Projects/PARAtask/paratime/src/app/app.component.ts", "TypeScript", 0, 9, 0, 0, 0, 0, 2, 11
"/media/roman/414054776F940E4C/Projects/PARAtask/paratime/src/app/app.module.ts", "TypeScript", 0, 100, 0, 0, 0, 0, 5, 105
"/media/roman/414054776F940E4C/Projects/PARAtask/paratime/src/app/common/date_formatter.ts", "TypeScript", 0, 5, 0, 0, 0, 1, 1, 7
"/media/roman/414054776F940E4C/Projects/PARAtask/paratime/src/app/common/dialog.ts", "TypeScript", 0, 9, 0, 0, 0, 0, 2, 11
"/media/roman/414054776F940E4C/Projects/PARAtask/paratime/src/app/common/edit_input_handler.ts", "TypeScript", 0, 11, 0, 0, 0, 0, 2, 13
"/media/roman/414054776F940E4C/Projects/PARAtask/paratime/src/app/common/filter/filter.ts", "TypeScript", 0, 21, 0, 0, 0, 0, 6, 27
"/media/roman/414054776F940E4C/Projects/PARAtask/paratime/src/app/common/filter/filterable.list.ts", "TypeScript", 0, 3, 0, 0, 0, 0, 1, 4
"/media/roman/414054776F940E4C/Projects/PARAtask/paratime/src/app/common/filter/filterable.ts", "TypeScript", 0, 3, 0, 0, 0, 0, 0, 3
"/media/roman/414054776F940E4C/Projects/PARAtask/paratime/src/app/common/filter/filtered_list.ts", "TypeScript", 0, 23, 0, 0, 0, 0, 7, 30
"/media/roman/414054776F940E4C/Projects/PARAtask/paratime/src/app/common/key_codes.ts", "TypeScript", 0, 4, 0, 0, 0, 0, 1, 5
"/media/roman/414054776F940E4C/Projects/PARAtask/paratime/src/app/common/keys/key_handler.ts", "TypeScript", 0, 8, 0, 0, 0, 0, 1, 9
"/media/roman/414054776F940E4C/Projects/PARAtask/paratime/src/app/common/lists/tasks.list.ts", "TypeScript", 0, 83, 0, 0, 0, 2, 15, 100
"/media/roman/414054776F940E4C/Projects/PARAtask/paratime/src/app/common/order/orderable.list.ts", "TypeScript", 0, 3, 0, 0, 0, 0, 2, 5
"/media/roman/414054776F940E4C/Projects/PARAtask/paratime/src/app/common/order/ordered.list.ts", "TypeScript", 0, 4, 0, 0, 0, 30, 10, 44
"/media/roman/414054776F940E4C/Projects/PARAtask/paratime/src/app/common/order/orderer.ts", "TypeScript", 0, 40, 0, 0, 0, 0, 7, 47
"/media/roman/414054776F940E4C/Projects/PARAtask/paratime/src/app/common/task/task.item.menu.ts", "TypeScript", 0, 38, 0, 0, 0, 0, 11, 49
"/media/roman/414054776F940E4C/Projects/PARAtask/paratime/src/app/common/valuse.ts", "TypeScript", 0, 3, 0, 0, 0, 0, 2, 5
"/media/roman/414054776F940E4C/Projects/PARAtask/paratime/src/app/common/view_helper.ts", "TypeScript", 0, 16, 0, 0, 0, 0, 3, 19
"/media/roman/414054776F940E4C/Projects/PARAtask/paratime/src/app/data.service.spec.ts", "TypeScript", 0, 12, 0, 0, 0, 0, 5, 17
"/media/roman/414054776F940E4C/Projects/PARAtask/paratime/src/app/data.service.ts", "TypeScript", 0, 14, 0, 0, 0, 1, 6, 21
"/media/roman/414054776F940E4C/Projects/PARAtask/paratime/src/app/data/common/models.ts", "TypeScript", 0, 20, 0, 0, 0, 0, 7, 27
"/media/roman/414054776F940E4C/Projects/PARAtask/paratime/src/app/data/common/models/insert.column.result.ts", "TypeScript", 0, 17, 0, 0, 0, 0, 5, 22
"/media/roman/414054776F940E4C/Projects/PARAtask/paratime/src/app/data/common/models/insert.kanban.task.result.ts", "TypeScript", 0, 17, 0, 0, 0, 0, 6, 23
"/media/roman/414054776F940E4C/Projects/PARAtask/paratime/src/app/data/common/models/insert.project.result.ts", "TypeScript", 0, 33, 0, 0, 0, 0, 10, 43
"/media/roman/414054776F940E4C/Projects/PARAtask/paratime/src/app/data/common/models/insert.subtask.result.ts", "TypeScript", 0, 17, 0, 0, 0, 0, 3, 20
"/media/roman/414054776F940E4C/Projects/PARAtask/paratime/src/app/data/common/models/insert.task.data.ts", "TypeScript", 0, 31, 0, 0, 0, 0, 10, 41
"/media/roman/414054776F940E4C/Projects/PARAtask/paratime/src/app/data/common/models/insert.task.result.ts", "TypeScript", 0, 32, 0, 0, 0, 0, 8, 40
"/media/roman/414054776F940E4C/Projects/PARAtask/paratime/src/app/data/common/order/order.controller.ts", "TypeScript", 0, 130, 0, 0, 0, 2, 18, 150
"/media/roman/414054776F940E4C/Projects/PARAtask/paratime/src/app/data/common/order/status.order.controller.ts", "TypeScript", 0, 17, 0, 0, 0, 1, 5, 23
"/media/roman/414054776F940E4C/Projects/PARAtask/paratime/src/app/data/common/repositories/kanban_columns_repository.ts", "TypeScript", 0, 12, 0, 0, 0, 0, 2, 14
"/media/roman/414054776F940E4C/Projects/PARAtask/paratime/src/app/data/common/repositories/kanban_tasks_repository.ts", "TypeScript", 0, 11, 0, 0, 0, 0, 2, 13
"/media/roman/414054776F940E4C/Projects/PARAtask/paratime/src/app/data/common/repositories/label_repository.ts", "TypeScript", 0, 11, 0, 0, 0, 0, 2, 13
"/media/roman/414054776F940E4C/Projects/PARAtask/paratime/src/app/data/common/repositories/orderable.repository.ts", "TypeScript", 0, 32, 0, 0, 0, 0, 9, 41
"/media/roman/414054776F940E4C/Projects/PARAtask/paratime/src/app/data/common/repositories/pomodoro_repository.ts", "TypeScript", 0, 12, 0, 0, 0, 1, 1, 14
"/media/roman/414054776F940E4C/Projects/PARAtask/paratime/src/app/data/common/repositories/project_repository.ts", "TypeScript", 0, 12, 0, 0, 0, 0, 2, 14
"/media/roman/414054776F940E4C/Projects/PARAtask/paratime/src/app/data/common/repositories/stage_repository.ts", "TypeScript", 0, 10, 0, 0, 0, 0, 2, 12
"/media/roman/414054776F940E4C/Projects/PARAtask/paratime/src/app/data/common/repositories/subtask_repository.ts", "TypeScript", 0, 10, 0, 0, 0, 0, 2, 12
"/media/roman/414054776F940E4C/Projects/PARAtask/paratime/src/app/data/common/repositories/task_labels_repository.ts", "TypeScript", 0, 9, 0, 0, 0, 0, 2, 11
"/media/roman/414054776F940E4C/Projects/PARAtask/paratime/src/app/data/common/repositories/task_repository.ts", "TypeScript", 0, 21, 0, 0, 0, 0, 2, 23
"/media/roman/414054776F940E4C/Projects/PARAtask/paratime/src/app/data/common/source.ts", "TypeScript", 0, 20, 0, 0, 0, 0, 1, 21
"/media/roman/414054776F940E4C/Projects/PARAtask/paratime/src/app/data/common/store/kanban.column.store.ts", "TypeScript", 0, 101, 0, 0, 0, 2, 12, 115
"/media/roman/414054776F940E4C/Projects/PARAtask/paratime/src/app/data/common/store/kanban.task.store.ts", "TypeScript", 0, 99, 0, 0, 0, 3, 23, 125
"/media/roman/414054776F940E4C/Projects/PARAtask/paratime/src/app/data/common/store/label_store.ts", "TypeScript", 0, 89, 0, 0, 0, 2, 16, 107
"/media/roman/414054776F940E4C/Projects/PARAtask/paratime/src/app/data/common/store/orderable.store.ts", "TypeScript", 0, 5, 0, 0, 0, 0, 2, 7
"/media/roman/414054776F940E4C/Projects/PARAtask/paratime/src/app/data/common/store/pomodoro_store.ts", "TypeScript", 0, 34, 0, 0, 0, 0, 11, 45
"/media/roman/414054776F940E4C/Projects/PARAtask/paratime/src/app/data/common/store/project_store.ts", "TypeScript", 0, 123, 0, 0, 0, 3, 14, 140
"/media/roman/414054776F940E4C/Projects/PARAtask/paratime/src/app/data/common/store/stage_store.ts", "TypeScript", 0, 71, 0, 0, 0, 3, 12, 86
"/media/roman/414054776F940E4C/Projects/PARAtask/paratime/src/app/data/common/store/subtask_store.ts", "TypeScript", 0, 56, 0, 0, 0, 0, 13, 69
"/media/roman/414054776F940E4C/Projects/PARAtask/paratime/src/app/data/common/store/task_store.ts", "TypeScript", 0, 277, 0, 0, 0, 13, 34, 324
"/media/roman/414054776F940E4C/Projects/PARAtask/paratime/src/app/data/common/store_manager.ts", "TypeScript", 0, 54, 0, 0, 0, 1, 13, 68
"/media/roman/414054776F940E4C/Projects/PARAtask/paratime/src/app/data/local/database.ts", "TypeScript", 0, 95, 0, 0, 0, 0, 17, 112
"/media/roman/414054776F940E4C/Projects/PARAtask/paratime/src/app/data/local/repositories/kanban_columns_repository.ts", "TypeScript", 0, 45, 0, 0, 0, 1, 14, 60
"/media/roman/414054776F940E4C/Projects/PARAtask/paratime/src/app/data/local/repositories/kanban_tasks_repository.ts", "TypeScript", 0, 45, 0, 0, 0, 0, 14, 59
"/media/roman/414054776F940E4C/Projects/PARAtask/paratime/src/app/data/local/repositories/label_repository.ts", "TypeScript", 0, 43, 0, 0, 0, 0, 15, 58
"/media/roman/414054776F940E4C/Projects/PARAtask/paratime/src/app/data/local/repositories/pomodoro_repository.ts", "TypeScript", 0, 51, 0, 0, 0, 2, 14, 67
"/media/roman/414054776F940E4C/Projects/PARAtask/paratime/src/app/data/local/repositories/project_repository.ts", "TypeScript", 0, 57, 0, 0, 0, 3, 17, 77
"/media/roman/414054776F940E4C/Projects/PARAtask/paratime/src/app/data/local/repositories/stage_repository.ts", "TypeScript", 0, 54, 0, 0, 0, 1, 14, 69
"/media/roman/414054776F940E4C/Projects/PARAtask/paratime/src/app/data/local/repositories/subtask_repository.ts", "TypeScript", 0, 38, 0, 0, 0, 0, 14, 52
"/media/roman/414054776F940E4C/Projects/PARAtask/paratime/src/app/data/local/repositories/task_labels_repository.ts", "TypeScript", 0, 37, 0, 0, 0, 0, 9, 46
"/media/roman/414054776F940E4C/Projects/PARAtask/paratime/src/app/data/local/repositories/task_repository.ts", "TypeScript", 0, 95, 0, 0, 0, 8, 26, 129
"/media/roman/414054776F940E4C/Projects/PARAtask/paratime/src/app/data/local/source.ts", "TypeScript", 0, 70, 0, 0, 0, 1, 13, 84
"/media/roman/414054776F940E4C/Projects/PARAtask/paratime/src/app/dialog/dialog.component.css", "CSS", 0, 0, 0, 0, 0, 0, 1, 1
"/media/roman/414054776F940E4C/Projects/PARAtask/paratime/src/app/dialog/dialog.component.html", "HTML", 0, 0, 0, 0, 7, 0, 0, 7
"/media/roman/414054776F940E4C/Projects/PARAtask/paratime/src/app/dialog/dialog.component.spec.ts", "TypeScript", 0, 20, 0, 0, 0, 0, 6, 26
"/media/roman/414054776F940E4C/Projects/PARAtask/paratime/src/app/dialog/dialog.component.ts", "TypeScript", 0, 15, 0, 0, 0, 0, 4, 19
"/media/roman/414054776F940E4C/Projects/PARAtask/paratime/src/app/kanban/controllers/column.controller.ts", "TypeScript", 0, 58, 0, 0, 0, 4, 9, 71
"/media/roman/414054776F940E4C/Projects/PARAtask/paratime/src/app/kanban/controllers/order.controller.ts", "TypeScript", 0, 119, 0, 0, 0, 0, 7, 126
"/media/roman/414054776F940E4C/Projects/PARAtask/paratime/src/app/kanban/controllers/task.controller.ts", "TypeScript", 0, 62, 0, 0, 0, 4, 12, 78
"/media/roman/414054776F940E4C/Projects/PARAtask/paratime/src/app/kanban/kanban.component.css", "CSS", 0, 0, 73, 0, 0, 2, 19, 94
"/media/roman/414054776F940E4C/Projects/PARAtask/paratime/src/app/kanban/kanban.component.html", "HTML", 0, 0, 0, 0, 315, 0, 14, 329
"/media/roman/414054776F940E4C/Projects/PARAtask/paratime/src/app/kanban/kanban.component.spec.ts", "TypeScript", 0, 20, 0, 0, 0, 0, 6, 26
"/media/roman/414054776F940E4C/Projects/PARAtask/paratime/src/app/kanban/kanban.component.ts", "TypeScript", 0, 164, 0, 0, 0, 4, 39, 207
"/media/roman/414054776F940E4C/Projects/PARAtask/paratime/src/app/kanban/kanban.model.ts", "TypeScript", 0, 140, 0, 0, 0, 9, 36, 185
"/media/roman/414054776F940E4C/Projects/PARAtask/paratime/src/app/labels/adding/label.adding.controller.ts", "TypeScript", 0, 60, 0, 0, 0, 0, 11, 71
"/media/roman/414054776F940E4C/Projects/PARAtask/paratime/src/app/labels/adding/label.adding.model.ts", "TypeScript", 0, 9, 0, 0, 0, 0, 3, 12
"/media/roman/414054776F940E4C/Projects/PARAtask/paratime/src/app/labels/common/label_view_state.ts", "TypeScript", 0, 25, 0, 0, 0, 0, 8, 33
"/media/roman/414054776F940E4C/Projects/PARAtask/paratime/src/app/labels/common/list.model.ts", "TypeScript", 0, 21, 0, 0, 0, 1, 7, 29
"/media/roman/414054776F940E4C/Projects/PARAtask/paratime/src/app/labels/editing/label.editing.controller.ts", "TypeScript", 0, 50, 0, 0, 0, 1, 12, 63
"/media/roman/414054776F940E4C/Projects/PARAtask/paratime/src/app/labels/editing/label.editing.model.ts", "TypeScript", 0, 9, 0, 0, 0, 0, 3, 12
"/media/roman/414054776F940E4C/Projects/PARAtask/paratime/src/app/labels/labels.component.css", "CSS", 0, 0, 36, 0, 0, 3, 12, 51
"/media/roman/414054776F940E4C/Projects/PARAtask/paratime/src/app/labels/labels.component.html", "HTML", 0, 0, 0, 0, 112, 1, 6, 119
"/media/roman/414054776F940E4C/Projects/PARAtask/paratime/src/app/labels/labels.component.spec.ts", "TypeScript", 0, 20, 0, 0, 0, 0, 6, 26
"/media/roman/414054776F940E4C/Projects/PARAtask/paratime/src/app/labels/labels.component.ts", "TypeScript", 0, 88, 0, 0, 0, 0, 13, 101
"/media/roman/414054776F940E4C/Projects/PARAtask/paratime/src/app/labels/removing/label.removing.controller.ts", "TypeScript", 0, 37, 0, 0, 0, 0, 5, 42
"/media/roman/414054776F940E4C/Projects/PARAtask/paratime/src/app/lists-container/lists-container.component.css", "CSS", 0, 0, 3, 0, 0, 0, 1, 4
"/media/roman/414054776F940E4C/Projects/PARAtask/paratime/src/app/lists-container/lists-container.component.html", "HTML", 0, 0, 0, 0, 10, 0, 2, 12
"/media/roman/414054776F940E4C/Projects/PARAtask/paratime/src/app/lists-container/lists-container.component.spec.ts", "TypeScript", 0, 20, 0, 0, 0, 0, 6, 26
"/media/roman/414054776F940E4C/Projects/PARAtask/paratime/src/app/lists-container/lists-container.component.ts", "TypeScript", 0, 23, 0, 0, 0, 1, 10, 34
"/media/roman/414054776F940E4C/Projects/PARAtask/paratime/src/app/main/component_control.ts", "TypeScript", 0, 28, 0, 0, 0, 0, 8, 36
"/media/roman/414054776F940E4C/Projects/PARAtask/paratime/src/app/main/main.component.css", "CSS", 0, 0, 57, 0, 0, 1, 21, 79
"/media/roman/414054776F940E4C/Projects/PARAtask/paratime/src/app/main/main.component.html", "HTML", 0, 0, 0, 0, 27, 20, 12, 59
"/media/roman/414054776F940E4C/Projects/PARAtask/paratime/src/app/main/main.component.spec.ts", "TypeScript", 0, 20, 0, 0, 0, 0, 6, 26
"/media/roman/414054776F940E4C/Projects/PARAtask/paratime/src/app/main/main.component.ts", "TypeScript", 0, 174, 0, 0, 0, 15, 49, 238
"/media/roman/414054776F940E4C/Projects/PARAtask/paratime/src/app/models/kanban.ts", "TypeScript", 0, 92, 0, 0, 0, 2, 25, 119
"/media/roman/414054776F940E4C/Projects/PARAtask/paratime/src/app/models/label.ts", "TypeScript", 0, 21, 0, 0, 0, 0, 6, 27
"/media/roman/414054776F940E4C/Projects/PARAtask/paratime/src/app/models/orderable.item.ts", "TypeScript", 0, 32, 0, 0, 0, 1, 10, 43
"/media/roman/414054776F940E4C/Projects/PARAtask/paratime/src/app/models/pomodoro.history.ts", "TypeScript", 0, 37, 0, 0, 0, 0, 11, 48
"/media/roman/414054776F940E4C/Projects/PARAtask/paratime/src/app/models/priority.ts", "TypeScript", 0, 7, 0, 0, 0, 0, 0, 7
"/media/roman/414054776F940E4C/Projects/PARAtask/paratime/src/app/models/project.ts", "TypeScript", 0, 103, 0, 0, 0, 0, 26, 129
"/media/roman/414054776F940E4C/Projects/PARAtask/paratime/src/app/models/project_type.ts", "TypeScript", 0, 6, 0, 0, 0, 0, 1, 7
"/media/roman/414054776F940E4C/Projects/PARAtask/paratime/src/app/models/stage.ts", "TypeScript", 0, 53, 0, 0, 0, 0, 14, 67
"/media/roman/414054776F940E4C/Projects/PARAtask/paratime/src/app/models/status.ts", "TypeScript", 0, 6, 0, 0, 0, 0, 2, 8
"/media/roman/414054776F940E4C/Projects/PARAtask/paratime/src/app/models/subtask.ts", "TypeScript", 0, 42, 0, 0, 0, 0, 12, 54
"/media/roman/414054776F940E4C/Projects/PARAtask/paratime/src/app/models/task.container.ts", "TypeScript", 0, 4, 0, 0, 0, 0, 2, 6
"/media/roman/414054776F940E4C/Projects/PARAtask/paratime/src/app/models/task.item.ts", "TypeScript", 0, 6, 0, 0, 0, 1, 4, 11
"/media/roman/414054776F940E4C/Projects/PARAtask/paratime/src/app/models/task.ts", "TypeScript", 0, 166, 0, 0, 0, 3, 46, 215
"/media/roman/414054776F940E4C/Projects/PARAtask/paratime/src/app/pomodoro-statistics/data-source/project.data.source.ts", "TypeScript", 0, 28, 0, 0, 0, 0, 7, 35
"/media/roman/414054776F940E4C/Projects/PARAtask/paratime/src/app/pomodoro-statistics/data-source/task.data.source.ts", "TypeScript", 0, 28, 0, 0, 0, 1, 11, 40
"/media/roman/414054776F940E4C/Projects/PARAtask/paratime/src/app/pomodoro-statistics/model.ts", "TypeScript", 0, 174, 0, 0, 0, 1, 39, 214
"/media/roman/414054776F940E4C/Projects/PARAtask/paratime/src/app/pomodoro-statistics/pomodoro-statistics.component.css", "CSS", 0, 0, 0, 0, 0, 0, 1, 1
"/media/roman/414054776F940E4C/Projects/PARAtask/paratime/src/app/pomodoro-statistics/pomodoro-statistics.component.html", "HTML", 0, 0, 0, 0, 45, 0, 12, 57
"/media/roman/414054776F940E4C/Projects/PARAtask/paratime/src/app/pomodoro-statistics/pomodoro-statistics.component.spec.ts", "TypeScript", 0, 20, 0, 0, 0, 0, 6, 26
"/media/roman/414054776F940E4C/Projects/PARAtask/paratime/src/app/pomodoro-statistics/pomodoro-statistics.component.ts", "TypeScript", 0, 70, 0, 0, 0, 0, 17, 87
"/media/roman/414054776F940E4C/Projects/PARAtask/paratime/src/app/pomodoro-statistics/sorter/project.data.sorter.ts", "TypeScript", 0, 34, 0, 0, 0, 2, 7, 43
"/media/roman/414054776F940E4C/Projects/PARAtask/paratime/src/app/pomodoro-statistics/sorter/task.data.sorter.ts", "TypeScript", 0, 34, 0, 0, 0, 2, 6, 42
"/media/roman/414054776F940E4C/Projects/PARAtask/paratime/src/app/pomodoro/model.ts", "TypeScript", 0, 51, 0, 0, 0, 0, 16, 67
"/media/roman/414054776F940E4C/Projects/PARAtask/paratime/src/app/pomodoro/pomodoro.component.css", "CSS", 0, 0, 60, 0, 0, 0, 12, 72
"/media/roman/414054776F940E4C/Projects/PARAtask/paratime/src/app/pomodoro/pomodoro.component.html", "HTML", 0, 0, 0, 0, 78, 1, 5, 84
"/media/roman/414054776F940E4C/Projects/PARAtask/paratime/src/app/pomodoro/pomodoro.component.spec.ts", "TypeScript", 0, 20, 0, 0, 0, 0, 6, 26
"/media/roman/414054776F940E4C/Projects/PARAtask/paratime/src/app/pomodoro/pomodoro.component.ts", "TypeScript", 0, 95, 0, 0, 0, 3, 18, 116
"/media/roman/414054776F940E4C/Projects/PARAtask/paratime/src/app/pomodoro/settings.ts", "TypeScript", 0, 30, 0, 0, 0, 0, 9, 39
"/media/roman/414054776F940E4C/Projects/PARAtask/paratime/src/app/pomodoro/state.ts", "TypeScript", 0, 5, 0, 0, 0, 0, 0, 5
"/media/roman/414054776F940E4C/Projects/PARAtask/paratime/src/app/pomodoro/storage/settings.storage.ts", "TypeScript", 0, 28, 0, 0, 0, 0, 7, 35
"/media/roman/414054776F940E4C/Projects/PARAtask/paratime/src/app/pomodoro/timer.ts", "TypeScript", 0, 162, 0, 0, 0, 12, 35, 209
"/media/roman/414054776F940E4C/Projects/PARAtask/paratime/src/app/project-details/model/change.detector.ts", "TypeScript", 0, 32, 0, 0, 0, 0, 7, 39
"/media/roman/414054776F940E4C/Projects/PARAtask/paratime/src/app/project-details/model/model.ts", "TypeScript", 0, 45, 0, 0, 0, 1, 10, 56
"/media/roman/414054776F940E4C/Projects/PARAtask/paratime/src/app/project-details/model/state.ts", "TypeScript", 0, 25, 0, 0, 0, 0, 9, 34
"/media/roman/414054776F940E4C/Projects/PARAtask/paratime/src/app/project-details/model/validator.ts", "TypeScript", 0, 21, 0, 0, 0, 0, 6, 27
"/media/roman/414054776F940E4C/Projects/PARAtask/paratime/src/app/project-details/project-details.component.css", "CSS", 0, 0, 37, 0, 0, 5, 13, 55
"/media/roman/414054776F940E4C/Projects/PARAtask/paratime/src/app/project-details/project-details.component.html", "HTML", 0, 0, 0, 0, 280, 1, 18, 299
"/media/roman/414054776F940E4C/Projects/PARAtask/paratime/src/app/project-details/project-details.component.spec.ts", "TypeScript", 0, 20, 0, 0, 0, 0, 6, 26
"/media/roman/414054776F940E4C/Projects/PARAtask/paratime/src/app/project-details/project-details.component.ts", "TypeScript", 0, 117, 0, 0, 0, 1, 17, 135
"/media/roman/414054776F940E4C/Projects/PARAtask/paratime/src/app/project-details/stage/project.stage.model.ts", "TypeScript", 0, 19, 0, 0, 0, 0, 6, 25
"/media/roman/414054776F940E4C/Projects/PARAtask/paratime/src/app/project-details/stage/project.stages.controller.ts", "TypeScript", 0, 60, 0, 0, 0, 1, 13, 74
"/media/roman/414054776F940E4C/Projects/PARAtask/paratime/src/app/projects/adding/projects.adding.controller.ts", "TypeScript", 0, 51, 0, 0, 0, 2, 13, 66
"/media/roman/414054776F940E4C/Projects/PARAtask/paratime/src/app/projects/adding/projects.adding.model.ts", "TypeScript", 0, 9, 0, 0, 0, 0, 3, 12
"/media/roman/414054776F940E4C/Projects/PARAtask/paratime/src/app/projects/common/model.ts", "TypeScript", 0, 52, 0, 0, 0, 2, 18, 72
"/media/roman/414054776F940E4C/Projects/PARAtask/paratime/src/app/projects/common/projects.loader.ts", "TypeScript", 0, 6, 0, 0, 0, 0, 2, 8
"/media/roman/414054776F940E4C/Projects/PARAtask/paratime/src/app/projects/common/special_list.ts", "TypeScript", 0, 4, 0, 0, 0, 0, 0, 4
"/media/roman/414054776F940E4C/Projects/PARAtask/paratime/src/app/projects/common/state.ts", "TypeScript", 0, 51, 0, 0, 0, 0, 16, 67
"/media/roman/414054776F940E4C/Projects/PARAtask/paratime/src/app/projects/events/project.event.ts", "TypeScript", 0, 10, 0, 0, 0, 1, 8, 19
"/media/roman/414054776F940E4C/Projects/PARAtask/paratime/src/app/projects/filtering/filter_model.ts", "TypeScript", 0, 33, 0, 0, 0, 0, 10, 43
"/media/roman/414054776F940E4C/Projects/PARAtask/paratime/src/app/projects/filtering/projects.filtering.controller.ts", "TypeScript", 0, 32, 0, 0, 0, 1, 6, 39
"/media/roman/414054776F940E4C/Projects/PARAtask/paratime/src/app/projects/projects.component.css", "CSS", 0, 0, 66, 0, 0, 7, 27, 100
"/media/roman/414054776F940E4C/Projects/PARAtask/paratime/src/app/projects/projects.component.html", "HTML", 0, 0, 0, 0, 106, 3, 17, 126
"/media/roman/414054776F940E4C/Projects/PARAtask/paratime/src/app/projects/projects.component.spec.ts", "TypeScript", 0, 20, 0, 0, 0, 0, 6, 26
"/media/roman/414054776F940E4C/Projects/PARAtask/paratime/src/app/projects/projects.component.ts", "TypeScript", 0, 100, 0, 0, 0, 9, 23, 132
"/media/roman/414054776F940E4C/Projects/PARAtask/paratime/src/app/projects/removing/projects.removing.controller.ts", "TypeScript", 0, 35, 0, 0, 0, 0, 8, 43
"/media/roman/414054776F940E4C/Projects/PARAtask/paratime/src/app/services/app/app.service.spec.ts", "TypeScript", 0, 12, 0, 0, 0, 0, 5, 17
"/media/roman/414054776F940E4C/Projects/PARAtask/paratime/src/app/services/app/app.service.ts", "TypeScript", 0, 35, 0, 0, 0, 1, 14, 50
"/media/roman/414054776F940E4C/Projects/PARAtask/paratime/src/app/services/task/task.service.spec.ts", "TypeScript", 0, 12, 0, 0, 0, 0, 5, 17
"/media/roman/414054776F940E4C/Projects/PARAtask/paratime/src/app/services/task/task.service.ts", "TypeScript", 0, 10, 0, 0, 0, 1, 4, 15
"/media/roman/414054776F940E4C/Projects/PARAtask/paratime/src/app/side-container/side-container.component.css", "CSS", 0, 0, 14, 0, 0, 0, 3, 17
"/media/roman/414054776F940E4C/Projects/PARAtask/paratime/src/app/side-container/side-container.component.html", "HTML", 0, 0, 0, 0, 10, 0, 1, 11
"/media/roman/414054776F940E4C/Projects/PARAtask/paratime/src/app/side-container/side-container.component.spec.ts", "TypeScript", 0, 20, 0, 0, 0, 0, 6, 26
"/media/roman/414054776F940E4C/Projects/PARAtask/paratime/src/app/side-container/side-container.component.ts", "TypeScript", 0, 28, 0, 0, 0, 0, 9, 37
"/media/roman/414054776F940E4C/Projects/PARAtask/paratime/src/app/special-lists/events/special.list.event.ts", "TypeScript", 0, 7, 0, 0, 0, 0, 3, 10
"/media/roman/414054776F940E4C/Projects/PARAtask/paratime/src/app/special-lists/special-lists.component.css", "CSS", 0, 0, 0, 0, 0, 0, 1, 1
"/media/roman/414054776F940E4C/Projects/PARAtask/paratime/src/app/special-lists/special-lists.component.html", "HTML", 0, 0, 0, 0, 16, 1, 4, 21
"/media/roman/414054776F940E4C/Projects/PARAtask/paratime/src/app/special-lists/special-lists.component.spec.ts", "TypeScript", 0, 20, 0, 0, 0, 0, 6, 26
"/media/roman/414054776F940E4C/Projects/PARAtask/paratime/src/app/special-lists/special-lists.component.ts", "TypeScript", 0, 18, 0, 0, 0, 1, 8, 27
"/media/roman/414054776F940E4C/Projects/PARAtask/paratime/src/app/stage-details/model.ts", "TypeScript", 0, 32, 0, 0, 0, 0, 9, 41
"/media/roman/414054776F940E4C/Projects/PARAtask/paratime/src/app/stage-details/stage-details.component.css", "CSS", 0, 0, 1, 0, 0, 0, 0, 1
"/media/roman/414054776F940E4C/Projects/PARAtask/paratime/src/app/stage-details/stage-details.component.html", "HTML", 0, 0, 0, 0, 59, 0, 9, 68
"/media/roman/414054776F940E4C/Projects/PARAtask/paratime/src/app/stage-details/stage-details.component.spec.ts", "TypeScript", 0, 20, 0, 0, 0, 0, 6, 26
"/media/roman/414054776F940E4C/Projects/PARAtask/paratime/src/app/stage-details/stage-details.component.ts", "TypeScript", 0, 32, 0, 0, 0, 0, 11, 43
"/media/roman/414054776F940E4C/Projects/PARAtask/paratime/src/app/task-details/labels/task.label.model.ts", "TypeScript", 0, 30, 0, 0, 0, 0, 7, 37
"/media/roman/414054776F940E4C/Projects/PARAtask/paratime/src/app/task-details/labels/task.labels.controller.ts", "TypeScript", 0, 99, 0, 0, 0, 5, 22, 126
"/media/roman/414054776F940E4C/Projects/PARAtask/paratime/src/app/task-details/model/change.detector.ts", "TypeScript", 0, 25, 0, 0, 0, 1, 6, 32
"/media/roman/414054776F940E4C/Projects/PARAtask/paratime/src/app/task-details/model/model.ts", "TypeScript", 0, 34, 0, 0, 0, 1, 10, 45
"/media/roman/414054776F940E4C/Projects/PARAtask/paratime/src/app/task-details/model/state.ts", "TypeScript", 0, 37, 0, 0, 0, 0, 13, 50
"/media/roman/414054776F940E4C/Projects/PARAtask/paratime/src/app/task-details/model/validator.ts", "TypeScript", 0, 13, 0, 0, 0, 0, 5, 18
"/media/roman/414054776F940E4C/Projects/PARAtask/paratime/src/app/task-details/subtask.view.ts", "TypeScript", 0, 21, 0, 0, 0, 0, 5, 26
"/media/roman/414054776F940E4C/Projects/PARAtask/paratime/src/app/task-details/subtasks/subtasks.editing.controller.ts", "TypeScript", 0, 93, 0, 0, 0, 1, 20, 114
"/media/roman/414054776F940E4C/Projects/PARAtask/paratime/src/app/task-details/subtasks/subtasks.editing.model.ts", "TypeScript", 0, 42, 0, 0, 0, 0, 13, 55
"/media/roman/414054776F940E4C/Projects/PARAtask/paratime/src/app/task-details/task-details.component.css", "CSS", 0, 0, 92, 0, 0, 7, 27, 126
"/media/roman/414054776F940E4C/Projects/PARAtask/paratime/src/app/task-details/task-details.component.html", "HTML", 0, 0, 0, 0, 236, 3, 28, 267
"/media/roman/414054776F940E4C/Projects/PARAtask/paratime/src/app/task-details/task-details.component.spec.ts", "TypeScript", 0, 20, 0, 0, 0, 0, 6, 26
"/media/roman/414054776F940E4C/Projects/PARAtask/paratime/src/app/task-details/task-details.component.ts", "TypeScript", 0, 154, 0, 0, 0, 5, 25, 184
"/media/roman/414054776F940E4C/Projects/PARAtask/paratime/src/app/tasks-container/task.list.ts", "TypeScript", 0, 12, 0, 0, 0, 1, 2, 15
"/media/roman/414054776F940E4C/Projects/PARAtask/paratime/src/app/tasks-container/tasks-container.component.css", "CSS", 0, 0, 6, 0, 0, 0, 2, 8
"/media/roman/414054776F940E4C/Projects/PARAtask/paratime/src/app/tasks-container/tasks-container.component.html", "HTML", 0, 0, 0, 0, 21, 1, 2, 24
"/media/roman/414054776F940E4C/Projects/PARAtask/paratime/src/app/tasks-container/tasks-container.component.spec.ts", "TypeScript", 0, 20, 0, 0, 0, 0, 6, 26
"/media/roman/414054776F940E4C/Projects/PARAtask/paratime/src/app/tasks-container/tasks-container.component.ts", "TypeScript", 0, 73, 0, 0, 0, 6, 21, 100
"/media/roman/414054776F940E4C/Projects/PARAtask/paratime/src/app/tasks/adding/task.adding.controller.ts", "TypeScript", 0, 65, 0, 0, 0, 1, 12, 78
"/media/roman/414054776F940E4C/Projects/PARAtask/paratime/src/app/tasks/adding/task.adding.model.ts", "TypeScript", 0, 19, 0, 0, 0, 0, 6, 25
"/media/roman/414054776F940E4C/Projects/PARAtask/paratime/src/app/tasks/common/special.list.ts", "TypeScript", 0, 40, 0, 0, 0, 1, 8, 49
"/media/roman/414054776F940E4C/Projects/PARAtask/paratime/src/app/tasks/common/task.item.controller.ts", "TypeScript", 0, 27, 0, 0, 0, 2, 7, 36
"/media/roman/414054776F940E4C/Projects/PARAtask/paratime/src/app/tasks/common/task.item.info.ts", "TypeScript", 0, 32, 0, 0, 0, 2, 4, 38
"/media/roman/414054776F940E4C/Projects/PARAtask/paratime/src/app/tasks/controllers/order.controller.ts", "TypeScript", 0, 18, 0, 0, 0, 1, 4, 23
"/media/roman/414054776F940E4C/Projects/PARAtask/paratime/src/app/tasks/filter_model.ts", "TypeScript", 0, 50, 0, 0, 0, 0, 14, 64
"/media/roman/414054776F940E4C/Projects/PARAtask/paratime/src/app/tasks/filtering/task.filtering.controller.ts", "TypeScript", 0, 68, 0, 0, 0, 3, 12, 83
"/media/roman/414054776F940E4C/Projects/PARAtask/paratime/src/app/tasks/filtering/task.filtering.model.ts", "TypeScript", 0, 17, 0, 0, 0, 0, 7, 24
"/media/roman/414054776F940E4C/Projects/PARAtask/paratime/src/app/tasks/model.ts", "TypeScript", 0, 66, 0, 0, 0, 1, 17, 84
"/media/roman/414054776F940E4C/Projects/PARAtask/paratime/src/app/tasks/task.type.ts", "TypeScript", 0, 4, 0, 0, 0, 0, 1, 5
"/media/roman/414054776F940E4C/Projects/PARAtask/paratime/src/app/tasks/tasks.component.css", "CSS", 0, 0, 49, 0, 0, 8, 15, 72
"/media/roman/414054776F940E4C/Projects/PARAtask/paratime/src/app/tasks/tasks.component.html", "HTML", 0, 0, 0, 0, 249, 0, 21, 270
"/media/roman/414054776F940E4C/Projects/PARAtask/paratime/src/app/tasks/tasks.component.spec.ts", "TypeScript", 0, 20, 0, 0, 0, 0, 6, 26
"/media/roman/414054776F940E4C/Projects/PARAtask/paratime/src/app/tasks/tasks.component.ts", "TypeScript", 0, 143, 0, 0, 0, 4, 25, 172
"/media/roman/414054776F940E4C/Projects/PARAtask/paratime/src/app/top-bar/top-bar.component.css", "CSS", 0, 0, 0, 0, 0, 0, 1, 1
"/media/roman/414054776F940E4C/Projects/PARAtask/paratime/src/app/top-bar/top-bar.component.html", "HTML", 0, 0, 0, 0, 5, 0, 1, 6
"/media/roman/414054776F940E4C/Projects/PARAtask/paratime/src/app/top-bar/top-bar.component.spec.ts", "TypeScript", 0, 20, 0, 0, 0, 0, 6, 26
"/media/roman/414054776F940E4C/Projects/PARAtask/paratime/src/app/top-bar/top-bar.component.ts", "TypeScript", 0, 11, 0, 0, 0, 0, 8, 19
"/media/roman/414054776F940E4C/Projects/PARAtask/paratime/src/app/widgets/timepicker/directives/timepicker-trigger.directive.spec.ts", "TypeScript", 0, 5, 0, 0, 0, 2, 2, 9
"/media/roman/414054776F940E4C/Projects/PARAtask/paratime/src/app/widgets/timepicker/directives/timepicker-trigger.directive.ts", "TypeScript", 0, 31, 0, 0, 0, 0, 13, 44
"/media/roman/414054776F940E4C/Projects/PARAtask/paratime/src/app/widgets/timepicker/directives/trigger.ts", "TypeScript", 0, 0, 0, 0, 0, 0, 2, 2
"/media/roman/414054776F940E4C/Projects/PARAtask/paratime/src/app/widgets/timepicker/time_model.ts", "TypeScript", 0, 13, 0, 0, 0, 0, 5, 18
"/media/roman/414054776F940E4C/Projects/PARAtask/paratime/src/app/widgets/timepicker/timepicker.component.css", "CSS", 0, 0, 21, 0, 0, 0, 4, 25
"/media/roman/414054776F940E4C/Projects/PARAtask/paratime/src/app/widgets/timepicker/timepicker.component.html", "HTML", 0, 0, 0, 0, 22, 0, 3, 25
"/media/roman/414054776F940E4C/Projects/PARAtask/paratime/src/app/widgets/timepicker/timepicker.component.spec.ts", "TypeScript", 0, 20, 0, 0, 0, 0, 6, 26
"/media/roman/414054776F940E4C/Projects/PARAtask/paratime/src/app/widgets/timepicker/timepicker.component.ts", "TypeScript", 0, 108, 0, 0, 0, 2, 26, 136
"/media/roman/414054776F940E4C/Projects/PARAtask/paratime/src/app/widgets/widgets.module.ts", "TypeScript", 0, 14, 0, 0, 0, 0, 3, 17
"/media/roman/414054776F940E4C/Projects/PARAtask/paratime/src/custom-theme.scss", "SCSS", 7, 0, 0, 0, 0, 14, 8, 29
"/media/roman/414054776F940E4C/Projects/PARAtask/paratime/src/environments/environment.prod.ts", "TypeScript", 0, 3, 0, 0, 0, 0, 1, 4
"/media/roman/414054776F940E4C/Projects/PARAtask/paratime/src/environments/environment.ts", "TypeScript", 0, 3, 0, 0, 0, 11, 3, 17
"/media/roman/414054776F940E4C/Projects/PARAtask/paratime/src/index.html", "HTML", 0, 0, 0, 0, 15, 0, 1, 16
"/media/roman/414054776F940E4C/Projects/PARAtask/paratime/src/main.js", "JavaScript", 0, 0, 0, 30, 0, 4, 11, 45
"/media/roman/414054776F940E4C/Projects/PARAtask/paratime/src/main.ts", "TypeScript", 0, 9, 0, 0, 0, 0, 4, 13
"/media/roman/414054776F940E4C/Projects/PARAtask/paratime/src/polyfills.ts", "TypeScript", 0, 2, 0, 0, 0, 58, 8, 68
"/media/roman/414054776F940E4C/Projects/PARAtask/paratime/src/styles.css", "CSS", 0, 0, 373, 0, 0, 14, 83, 470
"/media/roman/414054776F940E4C/Projects/PARAtask/paratime/src/test.ts", "TypeScript", 0, 18, 0, 0, 0, 4, 4, 26
"Total", "-", 7, 7506, 888, 30, 1614, 377, 2190, 12612